Naslov
- povijest - povijest je znanost koja prucava proslost ljudi
- era - dugo razdoblje koje pocinje nekim vaznim dogadajem
- arheologija - znanost koja istražuje materijalne izvore
- evolucija - prilagodba zivih bica okolini
- nomadi - ljudi koji se stalno sele
- velika povijesna razdoblja: prapovijest, stari vijek, srednji vijek, novi vijek, suvremeno doba
- podijela prapovijesti: kameno doba(neolitik, paleolitik), metalno doba(bakreno, broncano, zeljezno)
- paleolitik - starije kameno doba
- neolitik - mlade kameno doba
- homospaiens - razuman covijek
- nomadski zivot - skitalacki zivot
- neandertalci - ljudi koji su zivjeli prije 250 000 - 30 000 godina pr.Kr.
- Dragutin Gorjanaovic Kramberger - pronašao ostatke neandertalskog covjeka kod Krapine(Brdo Husnjakovo)
- Kromanjonci - nakon Nedaertalaca - slicniji danasnjim ljudima
- sojenice - nastambe iznad vode
- zemunice - nastambe ispod zemlje
- nalazišta starijeg kamenog doba u Hrvatskoj - Brdo husnjakovo, Veternica(špilja), Vindija(špilja)
- nalazišta mladeg kamenog doba u Hrvatskoj - Danilo(kod sibenika), Starcevacka kultura
- kulture - zajednice ljudi 
- vucedolska kultura - metalno doba - vucedol kod vukovara
- civilizacije prvih pisama - nastale uz velike rijeke(Nil - egipatska, Ind - indijska, euferat i tigris - mezopotamija, duga i zuta rijeka - kineska)
- pojava pisma 3500 g pr.Kr - kraj prapovijesti, pocetak starog vijeka
- papirus - podloga za pisanje(hijeroglifi - egipatsko pismo)
- vrste slikovnih  pisama: klinasto(mezopotamska), hijeroglifi(egipatska)
- faraon - vladar egipta
- piramida - grobnica faraona
- sfinga - cuvarica piramida
- monarhija - drzava kojom vlada jedan covjek - monarh(kralj, car, ..)
- dinastija - obitelj iz koje potjece vise vladara
- polis - grcki grad-drzava(najpoznatiji: Atena, Sparta)
- djelovi polisa - akropola, agora
- akropola - svetiste, gornji dio grada
- agora - trg, donji dio grada
- Partenon - hram bozici Ateni na atenskoj akropoli
- demos - narod
- demokracija - vladavina naroda
- aristokracija - vladavina najboljih
- kolonija - naselbina nekog naroda na tudem prostoru
- kolonizacija - naseljavanje tudeg prostora
- metropola - drzava iz koje se iseljavalo
- hoplit - tekso naoruzani ratnik u staroj grckoj(pješak)
- falanga - bojni poredak(filip II, Aleksandar Veliki)
- najpoznatije bitke grcko-prezijski ratova: maratonska bitka, bitka kod termopila, bitka kod salamine
- narodi apeninskog poluotoka: Gali, Etruscani, Latini, Grci, Italici
- senat - mjesto gdje su rimljani donosili odluke
- konzuli - imaju upravnu, sudsku i vojnu vlast u Rimskoj Republici
- S.P.Q.R - Senatus Populusque Romanus - naziv rimskog senata
- patriciji - ugledni rimljani
- plebejci - obican narod, nisu imali politicka prava
- pucki tribun - predstavnik plebejnaca u senatu
- legija - temeljna jedinica rimske vojske
- logor - vojna utvrda za smjestaj rimske vojske
- imperator - naziv za vrhovnog zapovjednika rimske vojske
- decimiranje - kazna
- trijumf - najveca nagrada - svecani ulazak imperatora nakon pobjede
- provincija - zemlja izvan Italije koju su rimljani osvoji i stavili pod svoju vlast
- romanzacija - sirenje rimskog utjecaja, latinskog jezika, pisma i kulture
- forum - rimski trg
- akvadukt - rimski vodovod
- gladijatori - uglavnom robovi, borili se u amfiteatru
- Koloseum - najveci amfiteratar u rimu
- reforma - promjena 
- rimska obitelj: pater familias(otac obitelji), mater familias(majka obitelji)
- kapitolijsko trojstvo: Jupiter, Junona i Minerva
- Oktavijan August - prvi rimski car
- Car Neron, car Dioklecijan - proganjali krscane
- limes - granica rimskog carstva
- milanski edikt - 313. g car Konstantin dopustio krscanstvo
- podjela rimskog carstva - 395. g car Teodozije veliki
- podjela rimskog carstva: zapadno(Rim), istocno(Konstantinopol)
- barbari - napadli granice rimskog carstva
- pad zapadnog rimskog carstva - 476. g Vandali
- migracije - preseljenje(seoba naroda)
- kraj staroga vijeka - 476. g, pocetak srednjeg vijeka
- podjela srednjeg vijeka(5. do 15. st.): rani, razvijeni, kasni
- srednjovjekovno drustvo = feudalno drustvo
- feud - zemljisni posjed
- feudalac - vlasnik feuda
- kmet - zavisni seljak, placa porez crkvi, feudalcu, drzavi
- alodij - dio feuda na kojem zivi feudalac
- cehovi - udruzenja obrtnika(u srednjem vijeku)
- gilde - udruzenja trgovaca(u srednjem vijeku)
- utjecaj crkve u srednjem vijeku - inkvizicija - crkvena institucija koja proganja nevjernike
- seliste - dio feuda na kojem zivi kmet
- islam - muslimanska vjera
- hidžra - 622. pocetak muslimanske vjere
- kuran - sveta knjiga islama
- najpoznatije sile u srednje vijeku: Franačka(karlo veliki), Bizant(Justinijan)
- pokrstavanje - nasilno i mirnim putem
- 7. st. - doseljenje Hrvata, 
- dinastija Trpimirovic
- hrvatski vladari 9.st: Trpimir, Branimir
- hrvatski vladari 10.st: Tomislav, Stjepan Drzislav
- hrvatski vladari 11.st: Petar Kresimir IV, Zvonimir
- Bascanska ploca - glagoljica(11.st.)
- 1102. Pacta Convetna - ugarsko-hrvatsko kraljestvo, dinistija Arpadovica
- personalna unija - zajednica dviju ili vise drzava koje imaju zajednickog vladara
- 1242. Zlatna bula Bele IV - grad Zagreb
- 14. st. - dinastija Anzuvinaca
- Zrinski i Frakopani - najpoznatiji hrvatski velikaski rodovi
- prodaja Dalmacije 1409. - prodaja Dalamcije Veneciji
- 16. st. Ostaci ostataka - doba najvece opasnosti od turaka
- sultan - vrhovni poglavar osmanskog carstva
- spahije - turski konjanici
- janjicari - turska pjesacka vojna jedinica
- najpoznatije bitke s Turcima: Krbavska bitka(1493. g, najveci hrvatski poraz), Mohacka bitka(1526. g, kraj ugarsko-hrvatskog kraljestva),
Sigetska bitka(1566. g, Nikola Subic Zrinski), bitka kod Siska(1593. g, bitka prekretnica - pobjeda)
- dolazak nove dinastije Habsburgovci - 1527. 
- 1054. Crveni raskol - podjela na katolicku i pravoslavnu crkvu (papa i patrijarh)
- 16. st. reformacija Martin Luther - podjela unutar katolicke crkve na: rimokatolike i protestante
- 1492. otkrice amerike(Kolumbo) - kraj srednjeg, pocetak novog vijeka
- umjetnicki stilovi(9. st. - 17. st.)srednjega i novoga vijeka: romanika, gotika, renesansa, barok
- umjetnicki stilovi(18. st. - 19. st.): klasicizam, romantizam, realizam
- dvorac Versailles - najpoznatiji barokni dvorac(17. st. - Luj XIV-simbol apsolutizma)





